客服電話  =>  客服電話
浪費錢  =>  浪費錢
客服人員  =>  客服人員
客服人數  =>  客服人數
客服專線  =>  客服專線
官網  =>  官網
網意見  =>  網意見
網路客服  =>  網路客服
客服動作  =>  客服動作
制式時間  =>  制式時間
案件時間  =>  案件時間
客服規定  =>  客服規定
包裹單子  =>  包裹單子
業務司機  =>  業務司機
司機少收  =>  司機少收
少收包裹  =>  少收包裹
業務少收  =>  業務少收
網收件  =>  網收件
黑貓業務  =>  黑貓業務
蝦皮包裹  =>  蝦皮包裹
態度口氣  =>  態度口氣
司機態度  =>  司機態度
司機講話  =>  司機講話
司機收貨  =>  司機收貨
方向燈  =>  方向燈
燈差點  =>  燈差點
交通號誌  =>  交通號誌
司機紅線  =>  司機紅線
司機紅燈  =>  司機紅燈
紅燈右轉  =>  紅燈右轉
時間收貨  =>  時間收貨
司機闖紅燈  =>  司機闖紅燈
問個問題態度  =>  問個問題態度
黑貓司機  =>  黑貓司機
司機包裹  =>  司機包裹
司機差點  =>  司機差點
司機肇事  =>  司機肇事
業務態度  =>  業務態度
講話口氣  =>  講話口氣
客服態度  =>  客服態度
客服客  =>  客服客
客服講話  =>  客服講話
客服服務態度  =>  客服服務態度
黑貓客服  =>  黑貓客服
人員態度  =>  人員態度
講話語氣  =>  講話語氣
營業所主管  =>  營業所主管
聯絡方式  =>  聯絡方式
營業所服務態度  =>  營業所服務態度
主管服務態度  =>  主管服務態度
黑貓主管  =>  黑貓主管
黑貓營業所  =>  黑貓營業所
誤會司機  =>  誤會司機
黑貓快遞  =>  黑貓快遞
低溫包裹  =>  低溫包裹
低溫宅  =>  低溫宅
常溫貨車  =>  常溫貨車
人員講話  =>  人員講話
冰袋冰  =>  冰袋冰
人聯絡  =>  人聯絡
包裹寄放在  =>  包裹寄放在
寄放在鄰居家  =>  寄放在鄰居家
公司行號  =>  公司行號
包裹數量  =>  包裹數量
包裹件數  =>  包裹件數
時候數目  =>  時候數目
包裹數目  =>  包裹數目
包裹司機  =>  包裹司機
時段幹嘛  =>  時段幹嘛
規定時間  =>  規定時間
辦法收貨  =>  辦法收貨
收貨司機  =>  收貨司機
照著  =>  照著
包裹貨  =>  包裹貨
貨故  =>  貨故
包裹包裝箱  =>  包裹包裝箱
包裹紙箱  =>  包裹紙箱
紙箱全部  =>  紙箱全部
包裹袋子  =>  包裹袋子
辦公室電話  =>  辦公室電話
主管連絡  =>  主管連絡
經理連絡  =>  經理連絡
連絡電話  =>  連絡電話
紙箱膠帶  =>  紙箱膠帶
內容收件人  =>  內容收件人
時候包裹  =>  時候包裹
小米包裹  =>  小米包裹
包裹卡  =>  包裹卡
包裹狀態  =>  包裹狀態
問客服  =>  問客服
包裹方式  =>  包裹方式
包裹號碼  =>  包裹號碼
訂單狀態  =>  訂單狀態
支電話  =>  支電話
包裹寄件人  =>  包裹寄件人
代表黑貓  =>  代表黑貓
小時內  =>  小時內
黑貓關係  =>  黑貓關係
小時包裹  =>  小時包裹
商品原本  =>  商品原本
網下單  =>  網下單
收件人電話  =>  收件人電話
蘋果下單  =>  蘋果下單
蘋果手機  =>  蘋果手機
聯絡人電話  =>  聯絡人電話
蘋果官  =>  蘋果官
網買手機  =>  網買手機
收件地址  =>  收件地址
聯絡電話  =>  聯絡電話
住家地址  =>  住家地址
收件住址  =>  收件住址
時間無法  =>  時間無法
手機原本  =>  手機原本
包裹下單  =>  包裹下單
小米官  =>  小米官
小米商品  =>  小米商品
小米手機  =>  小米手機
小米下單  =>  小米下單
小米手環  =>  小米手環
小米原本  =>  小米原本
業務包裹  =>  業務包裹
包裹辦理  =>  包裹辦理
貨態  =>  貨態
原因狀態  =>  原因狀態
包裹遺失  =>  包裹遺失
包裹編號  =>  包裹編號
訂單內容  =>  訂單內容
系統無法  =>  系統無法
訂單資料  =>  訂單資料
遺失包裹  =>  遺失包裹
編號原因  =>  編號原因
訂單編號  =>  訂單編號
包裹資料  =>  包裹資料
貨結果  =>  貨結果
傳簡訊  =>  傳簡訊
電話聯絡  =>  電話聯絡
傳訊息  =>  傳訊息
貨運司機  =>  貨運司機
態資訊  =>  態資訊
筆單  =>  筆單
包裹收件人  =>  包裹收件人
對方住址  =>  對方住址
管理員收件  =>  管理員收件
金額數目  =>  金額數目
收件人地址  =>  收件人地址
收款金額  =>  收款金額
包裹電話  =>  包裹電話
包裹款項  =>  包裹款項
款項問題  =>  款項問題
錢金額  =>  錢金額
收貨款項  =>  收貨款項
錢數目  =>  錢數目
司機先生  =>  司機先生
司機錢  =>  司機錢
快遞錢  =>  快遞錢
黑貓錢  =>  黑貓錢
營業所拿貨  =>  營業所拿貨
商品寄放在  =>  商品寄放在
原本宅  =>  原本宅
問題客服  =>  問題客服
客服聯絡  =>  客服聯絡
問問題  =>  問問題
貨品狀態  =>  貨品狀態
網包裹  =>  網包裹
包裹廠商  =>  包裹廠商
代收款項  =>  代收款項
收款狀況  =>  收款狀況
收款款項  =>  收款款項
貨款金額  =>  貨款金額
業務代收款  =>  業務代收款
集貨代表  =>  集貨代表
指收件人  =>  指收件人
情況狀態  =>  情況狀態
集貨狀態  =>  集貨狀態
指聯絡  =>  指聯絡
指黑貓  =>  指黑貓
包裹公司  =>  包裹公司
地址公司  =>  地址公司
態公司  =>  態公司
指客人  =>  指客人
客人公司  =>  客人公司
收件人公司  =>  收件人公司
態代表  =>  態代表
代表司機  =>  代表司機
指司機  =>  指司機
時間代表  =>  時間代表
狀態問題  =>  狀態問題
司機電話  =>  司機電話
人收件  =>  人收件
包裹狀況  =>  包裹狀況
住址錯誤  =>  住址錯誤
寄放在營業所  =>  寄放在營業所
客人聯絡  =>  客人聯絡
黑貓包裹  =>  黑貓包裹
黑貓貨  =>  黑貓貨
狀況有點  =>  狀況有點
有點問題  =>  有點問題
收件時間  =>  收件時間
態意思  =>  態意思
情況包裹  =>  情況包裹
營業所貨  =>  營業所貨
營業所狀態  =>  營業所狀態
營業所代表  =>  營業所代表
物流中心  =>  物流中心
人姓名  =>  人姓名
包裹內容  =>  包裹內容
包裹地址  =>  包裹地址
包裹物品  =>  包裹物品
收件資料  =>  收件資料
錯誤包裹  =>  錯誤包裹
錯誤地址  =>  錯誤地址
地址包裹  =>  地址包裹
司機馬  =>  司機馬
雙證件  =>  雙證件
證件影本  =>  證件影本
包裹系統  =>  包裹系統
聯絡客服  =>  聯絡客服
包裹資訊  =>  包裹資訊
客人收件  =>  客人收件
司機聯絡  =>  司機聯絡
業務聯絡  =>  業務聯絡
業務人員電話  =>  業務人員電話
快遞聯絡  =>  快遞聯絡
人員聯絡  =>  人員聯絡
人通話  =>  人通話
業務電話  =>  業務電話
客戶收款  =>  客戶收款
客專區  =>  客專區
交易憑證  =>  交易憑證
單據編號  =>  單據編號
單子內容  =>  單子內容
城購物中心  =>  城購物中心
購物中心包裹  =>  購物中心包裹
城購物  =>  城購物
城集貨  =>  城集貨
包裹集貨  =>  包裹集貨
收件人資料  =>  收件人資料
收件資訊  =>  收件資訊
包裹代收款  =>  包裹代收款
對岸商品  =>  對岸商品
家人刷卡  =>  家人刷卡
包裹錢  =>  包裹錢
刷卡收件  =>  刷卡收件
信用卡持卡人  =>  信用卡持卡人
卡刷卡  =>  卡刷卡
媽媽刷卡  =>  媽媽刷卡
收件人無法  =>  收件人無法
刷卡原因  =>  刷卡原因
收件人刷卡  =>  收件人刷卡
人刷卡  =>  人刷卡
老婆刷卡  =>  老婆刷卡
金融卡  =>  金融卡
刷卡卡  =>  刷卡卡
信用卡刷卡  =>  信用卡刷卡
刷卡信用卡  =>  刷卡信用卡
信用卡種類  =>  信用卡種類
VISA卡結帳  =>  VISA卡結帳
信用卡結帳  =>  信用卡結帳
黑貓宅  =>  黑貓宅
實體店鋪  =>  實體店鋪
收件人名字  =>  收件人名字
訂單地址  =>  訂單地址
貨時間  =>  貨時間
小時速達  =>  小時速達
包裹原本  =>  包裹原本
問包裹  =>  問包裹
聯絡收件人  =>  聯絡收件人
黑貓會員  =>  黑貓會員
會員貨  =>  會員貨
收件人包裹  =>  收件人包裹
連絡收件人  =>  連絡收件人
網路宅  =>  網路宅
寄件人包裹  =>  寄件人包裹
櫃代領  =>  櫃代領
代領包裹  =>  代領包裹
收件人資訊  =>  收件人資訊
黑貓網站  =>  黑貓網站
無貨態  =>  無貨態
港口報關行  =>  港口報關行
報關行收件  =>  報關行收件
報關行包裹  =>  報關行包裹
黑貓無法  =>  黑貓無法
土石流  =>  土石流
甲媽  =>  甲媽
甲媽祖  =>  甲媽祖
駐點地點  =>  駐點地點
媽駐點  =>  媽駐點
時候黑貓  =>  時候黑貓
攤位駐點  =>  攤位駐點
駐點時間  =>  駐點時間
行程服務站  =>  行程服務站
攤位地址  =>  攤位地址
黑貓媽祖  =>  黑貓媽祖
地點媽  =>  地點媽
時間範圍  =>  時間範圍
區分成  =>  區分成
時間區間  =>  時間區間
期無法  =>  期無法
聯絡業務  =>  聯絡業務
蝦皮訂單  =>  蝦皮訂單
蝦皮購物  =>  蝦皮購物
蝦皮下單  =>  蝦皮下單
收貨地址  =>  收貨地址
蝦皮客戶  =>  蝦皮客戶
水果禮盒  =>  水果禮盒
低溫物品  =>  低溫物品
人態度  =>  人態度
目的資料  =>  目的資料
包裹方法  =>  包裹方法
機場宅  =>  機場宅
範圍內  =>  範圍內
規定條件  =>  規定條件
集貨資料  =>  集貨資料
手機軟體  =>  手機軟體
集貨地址  =>  集貨地址
集貨方法  =>  集貨方法
收貨時間  =>  收貨時間
包裹收件  =>  包裹收件
集貨時間  =>  集貨時間
單系統  =>  單系統
客代號  =>  客代號
無法建檔  =>  無法建檔
建檔資料  =>  建檔資料
網頁格式  =>  網頁格式
頁面內容  =>  頁面內容
系統版本  =>  系統版本
系統問題  =>  系統問題
收件司機  =>  收件司機
黑貓收件  =>  黑貓收件
黑貓收貨  =>  黑貓收貨
時間收件  =>  時間收件
包裹網站  =>  包裹網站
收件單  =>  收件單
網集貨  =>  網集貨
收件業務  =>  收件業務
收件包裹  =>  收件包裹
地址錯誤  =>  地址錯誤
包裹無法  =>  包裹無法
包裹內  =>  包裹內
物品價值  =>  物品價值
規定價值  =>  規定價值
價值規定  =>  價值規定
價值限額  =>  價值限額
限額費用  =>  限額費用
包裹金額  =>  包裹金額
商品價值  =>  商品價值
包裹價值  =>  包裹價值
價值額度  =>  價值額度
物品金額  =>  物品金額
商品金額  =>  商品金額
包裹價格  =>  包裹價格
單價包裹  =>  單價包裹
黑貓小心  =>  黑貓小心
貨品價值  =>  貨品價值
高額商品  =>  高額商品
貨物金額  =>  貨物金額
貨物價格  =>  貨物價格
貴重物品黑貓  =>  貴重物品黑貓
收報值  =>  收報值
報值包裹  =>  報值包裹
包裹黑貓  =>  包裹黑貓
高價精品  =>  高價精品
客服中心  =>  客服中心
貨物狀態  =>  貨物狀態
貨號碼  =>  貨號碼
收件編號  =>  收件編號
客戶收件  =>  客戶收件
倉庫收貨  =>  倉庫收貨
客戶收貨  =>  客戶收貨
便利商店門市  =>  便利商店門市
司機門市  =>  司機門市
門市收件  =>  門市收件
門市收貨  =>  門市收貨
店收件  =>  店收件
門市地址  =>  門市地址
門市時間  =>  門市時間
店時間  =>  店時間
商收件  =>  商收件
店捲尺  =>  店捲尺
店旗子  =>  店旗子
店旗幟  =>  店旗幟
黑貓旗子  =>  黑貓旗子
黑貓旗  =>  黑貓旗
店內  =>  店內
內量  =>  內量
量包裹  =>  量包裹
捲尺故障  =>  捲尺故障
面捲尺  =>  面捲尺
營業地址  =>  營業地址
營業所地址  =>  營業所地址
板橋營  =>  板橋營
營業所聯絡  =>  營業所聯絡
營業所電話  =>  營業所電話
營業時間資料  =>  營業時間資料
營業狀態  =>  營業狀態
服務處營業時間  =>  服務處營業時間
營業所營業時間  =>  營業所營業時間
包裹問題  =>  包裹問題
區域營業所  =>  區域營業所
營業所營運  =>  營業所營運
營運時間  =>  營運時間
營業所有人  =>  營業所有人
門市營業時間  =>  門市營業時間
雄轉運站  =>  雄轉運站
時候營業所  =>  時候營業所
營業所關門  =>  營業所關門
黑貓店  =>  黑貓店
街營業  =>  街營業
關門時間  =>  關門時間
營業所時間  =>  營業所時間
營業所營業  =>  營業所營業
高爾夫球場廠商  =>  高爾夫球場廠商
黑貓球  =>  黑貓球
專案合約  =>  專案合約
客專案  =>  客專案
球袋裝  =>  球袋裝
袋裝球  =>  袋裝球
袋裝著  =>  袋裝著
包裹外表  =>  包裹外表
保護套黑貓  =>  保護套黑貓
地址收件  =>  地址收件
收件方式  =>  收件方式
單支  =>  單支
支球  =>  支球
專用箱規格  =>  專用箱規格
液晶電視螢幕  =>  液晶電視螢幕
螢幕專用  =>  螢幕專用
電腦螢幕  =>  電腦螢幕
電腦主機紙箱  =>  電腦主機紙箱
蛋糕專用  =>  蛋糕專用
蛋糕紙箱  =>  蛋糕紙箱
專屬電視  =>  專屬電視
螢幕紙箱  =>  螢幕紙箱
蛋糕專用箱  =>  蛋糕專用箱
電視專用箱  =>  電視專用箱
螢幕專用箱  =>  螢幕專用箱
分廠牌  =>  分廠牌
電腦紙箱  =>  電腦紙箱
蛋糕指  =>  蛋糕指
指尺寸  =>  指尺寸
專用紙盒  =>  專用紙盒
專用紙箱  =>  專用紙箱
電腦主機專用  =>  電腦主機專用
電腦主機專用箱  =>  電腦主機專用箱
司機收件  =>  司機收件
封箱膠帶  =>  封箱膠帶
黑貓紙箱  =>  黑貓紙箱
黑貓紙盒包裝  =>  黑貓紙盒包裝
紙箱用紙  =>  紙箱用紙
用紙袋裝  =>  用紙袋裝
資材種類  =>  資材種類
方式建議  =>  方式建議
規定紙箱  =>  規定紙箱
包裹裝箱  =>  包裹裝箱
箱子內  =>  箱子內
紙袋封口  =>  紙袋封口
紙箱類型  =>  紙箱類型
商品建議  =>  商品建議
箱子包裝箱  =>  箱子包裝箱
公司紙箱  =>  公司紙箱
彌月蛋糕  =>  彌月蛋糕
紙箱種類  =>  紙箱種類
有點空空  =>  有點空空
紙箱有點  =>  紙箱有點
有點空  =>  有點空
成方形  =>  成方形
網路賣家  =>  網路賣家
黃色文件袋  =>  黃色文件袋
黃色袋子  =>  黃色袋子
用紙箱包  =>  用紙箱包
低溫商品  =>  低溫商品
低溫紙箱裝  =>  低溫紙箱裝
包裹溫度  =>  包裹溫度
冷藏包裹  =>  冷藏包裹
低溫水果  =>  低溫水果
低溫甜品  =>  低溫甜品
低溫漁  =>  低溫漁
漁貨  =>  漁貨
紙箱裝低溫  =>  紙箱裝低溫
常溫包裹  =>  常溫包裹
報紙先包  =>  報紙先包
袋裝水餃  =>  袋裝水餃
酒類商品  =>  酒類商品
壓克力磚  =>  壓克力磚
箱子裝箱  =>  箱子裝箱
箱子很漂亮  =>  箱子很漂亮
行李吊牌  =>  行李吊牌
替代方式  =>  替代方式
司機拿貨  =>  司機拿貨
低溫狀態  =>  低溫狀態
司機理貨  =>  司機理貨
理貨時會  =>  理貨時會
母乳回家  =>  母乳回家
母乳庫  =>  母乳庫
母乳注意事項  =>  母乳注意事項
彌月禮盒  =>  彌月禮盒
提袋禮盒  =>  提袋禮盒
袋裝禮盒  =>  袋裝禮盒
月餅禮盒  =>  月餅禮盒
專用提袋  =>  專用提袋
電腦鍵盤  =>  電腦鍵盤
液晶螢幕  =>  液晶螢幕
原本產品  =>  原本產品
產品紙箱  =>  產品紙箱
電腦液晶  =>  電腦液晶
低溫紙箱  =>  低溫紙箱
黑貓專用  =>  黑貓專用
常溫低溫  =>  常溫低溫
水果商品  =>  水果商品
冷藏蛋糕  =>  冷藏蛋糕
糕點餅乾  =>  糕點餅乾
醫藥用品  =>  醫藥用品
魚品肉類  =>  魚品肉類
玻璃物品  =>  玻璃物品
尺寸範圍  =>  尺寸範圍
尺寸指  =>  尺寸指
尺寸規格  =>  尺寸規格
規定尺寸  =>  規定尺寸
客戶代碼  =>  客戶代碼
客戶編號  =>  客戶編號
行號地址  =>  行號地址
帳單地址  =>  帳單地址
包裹尺寸  =>  包裹尺寸
連絡人  =>  連絡人
人電話  =>  人電話
會員地址  =>  會員地址
匯款帳號  =>  匯款帳號
客戶會員資料  =>  客戶會員資料
客戶電話  =>  客戶電話
客會員  =>  客會員
收件少收  =>  收件少收
業務收件  =>  業務收件
收件客服  =>  收件客服
限時包裹  =>  限時包裹
急件包裹  =>  急件包裹
收費標準  =>  收費標準
錢司機  =>  錢司機
寄件人電話  =>  寄件人電話
原本低溫  =>  原本低溫
原本常溫  =>  原本常溫
集貨訂單  =>  集貨訂單
網路訂單  =>  網路訂單
資料錯誤  =>  資料錯誤
貨方  =>  貨方
客收貨  =>  客收貨
甲地收貨  =>  甲地收貨
商門市  =>  商門市
貨方式  =>  貨方式
委託黑貓  =>  委託黑貓
集貨地點  =>  集貨地點
物流收件  =>  物流收件
蝦皮系統  =>  蝦皮系統
時候會派  =>  時候會派
會派人  =>  會派人
蝦皮貨物  =>  蝦皮貨物
大量貨物  =>  大量貨物
地區黑貓  =>  地區黑貓
包裹距離  =>  包裹距離
貨包裹  =>  貨包裹
精密儀器注意事項  =>  精密儀器注意事項
掃地機器人  =>  掃地機器人
智能電鍋  =>  智能電鍋
電子產  =>  電子產
產品類  =>  產品類
體脂  =>  體脂
脂機  =>  脂機
本島價  =>  本島價
地區金門  =>  地區金門
金門全區  =>  金門全區
金門地區  =>  金門地區
鄉田  =>  鄉田
地區綠島  =>  地區綠島
綠島地區  =>  綠島地區
範圍地區  =>  範圍地區
金門全部  =>  金門全部
包裹種類  =>  包裹種類
活體動物  =>  活體動物
規定包裹  =>  規定包裹
低溫冷藏車  =>  低溫冷藏車
個人證件  =>  個人證件
狗回家  =>  狗回家
奶油蛋糕  =>  奶油蛋糕
造型蛋糕  =>  造型蛋糕
鮮奶油蛋糕  =>  鮮奶油蛋糕
奶油造型  =>  奶油造型
油類蛋糕  =>  油類蛋糕
規範條件  =>  規範條件
縣市公告  =>  縣市公告
班資訊  =>  班資訊
地址司機  =>  地址司機
路交叉口  =>  路交叉口
交叉路口司機  =>  交叉路口司機
郵政信箱收件  =>  郵政信箱收件
郵局信箱  =>  郵局信箱
寄放在郵政信箱  =>  寄放在郵政信箱
郵政信箱內  =>  郵政信箱內
貨寄放在  =>  貨寄放在
低溫冷藏  =>  低溫冷藏
冷藏宅  =>  冷藏宅
冷藏貨品  =>  冷藏貨品
冷藏商品  =>  冷藏商品
店地址  =>  店地址
島包裹  =>  島包裹
地區包裹  =>  地區包裹
地區低溫  =>  地區低溫
金門對方  =>  金門對方
島司機  =>  島司機
貨地點  =>  貨地點
飛機空運  =>  飛機空運
空運結果  =>  空運結果
空運違禁品  =>  空運違禁品
電子訂單  =>  電子訂單
訂單收件  =>  訂單收件
店收貨  =>  店收貨
貨量  =>  貨量
時間規定  =>  時間規定
訂單包裹  =>  訂單包裹
電子單  =>  電子單
電話辦理  =>  電話辦理
訂單單  =>  訂單單
司機時間  =>  司機時間
包裹宅  =>  包裹宅
包裹太重  =>  包裹太重
包裹有點  =>  包裹有點
包裹重量  =>  包裹重量
規定內  =>  規定內
規定重量  =>  規定重量
單件包裹  =>  單件包裹
商品資料  =>  商品資料
收貨方  =>  收貨方
時間內  =>  時間內
營業所鐵門  =>  營業所鐵門
營業情況  =>  營業情況
地點距離  =>  地點距離
尺寸丈量  =>  尺寸丈量
計價方式  =>  計價方式
方形有點  =>  方形有點
包裹圓  =>  包裹圓
丈量尺寸  =>  丈量尺寸
收費方式  =>  收費方式
貨品尺寸  =>  貨品尺寸
圓形包裹  =>  圓形包裹
圓柱型包裹  =>  圓柱型包裹
商品尺寸  =>  商品尺寸
圓柱型商品  =>  圓柱型商品
方式量  =>  方式量
計費方式  =>  計費方式
照距離  =>  照距離
價格對照表  =>  價格對照表
島價格  =>  島價格
本島價格  =>  本島價格
商店街  =>  商店街
物流集貨  =>  物流集貨
刷卡手續費  =>  刷卡手續費
消費者刷卡  =>  消費者刷卡
手續費費率  =>  手續費費率
客戶刷卡  =>  客戶刷卡
客刷卡  =>  客刷卡
貨款刷卡  =>  貨款刷卡
消費者手續費  =>  消費者手續費
匯款銀行  =>  匯款銀行
會扣手續費  =>  會扣手續費
匯款手續費  =>  匯款手續費
貨款手續費  =>  貨款手續費
貨款黑貓  =>  貨款黑貓
金額費用  =>  金額費用
代扣金額  =>  代扣金額
個人用戶代收款  =>  個人用戶代收款
客服時間  =>  客服時間
對方貨  =>  對方貨
辦理貨  =>  辦理貨
個人用戶貨  =>  個人用戶貨
黑貓官  =>  黑貓官
商品費用  =>  商品費用
黑貓收款  =>  黑貓收款
商品貨款  =>  商品貨款
費用黑貓  =>  費用黑貓
商品錢  =>  商品錢
貨款費用  =>  貨款費用
收件人收款  =>  收件人收款
司機收款  =>  司機收款
賣家賣東西  =>  賣家賣東西
黑貓代收款  =>  黑貓代收款
客人貨  =>  客人貨
刷卡功能  =>  刷卡功能
公司帳戶  =>  公司帳戶
客戶貨  =>  客戶貨
帳戶影本  =>  帳戶影本
包裹收款  =>  包裹收款
收款方式  =>  收款方式
金額刷卡  =>  金額刷卡
收件人現金  =>  收件人現金
部份刷卡  =>  部份刷卡
收款方法  =>  收款方法
客戶原本  =>  客戶原本
原本包裹  =>  原本包裹
時候現金  =>  時候現金
刷卡貨  =>  刷卡貨
島刷卡  =>  島刷卡
原本刷卡  =>  原本刷卡
無法作業  =>  無法作業
卡結帳  =>  卡結帳
黑貓客  =>  黑貓客
法人身分  =>  法人身分
刷卡系統  =>  刷卡系統
公告年貨  =>  公告年貨
客價  =>  客價
合約價格  =>  合約價格
商無法  =>  商無法
系統平台  =>  系統平台
供應鏈平台  =>  供應鏈平台
密碼系統  =>  密碼系統
平台密碼  =>  平台密碼
供應鏈帳號  =>  供應鏈帳號
密碼結果  =>  密碼結果
平台資訊  =>  平台資訊
帳號資料  =>  帳號資料
功能列表  =>  功能列表
信箱帳號  =>  信箱帳號
基本基料  =>  基本基料
客戶專區  =>  客戶專區
問題問  =>  問題問
客帳號密碼  =>  客帳號密碼
客戶帳號密碼  =>  客戶帳號密碼
客戶代表  =>  客戶代表
器客  =>  器客
身分證字號  =>  身分證字號
代碼遺失  =>  代碼遺失
客戶代號  =>  客戶代號
專區集貨  =>  專區集貨
收件訂單  =>  收件訂單
客線  =>  客線
專屬套印  =>  專屬套印
結果格式  =>  結果格式
客官網  =>  客官網
客戶官  =>  客戶官
套印程式  =>  套印程式
營業所辦理  =>  營業所辦理
客戶聯繫  =>  客戶聯繫
大量物品  =>  大量物品
客合約  =>  客合約
公司法人才  =>  公司法人才
客戶內容  =>  客戶內容
辦理成  =>  辦理成
辦理方法  =>  辦理方法
黑貓辦理  =>  黑貓辦理
公司名義  =>  公司名義
身分證明  =>  身分證明
營業證明  =>  營業證明
核營業  =>  核營業
營業抄本  =>  營業抄本
水果專案  =>  水果專案
抄本會計師  =>  抄本會計師
水果地址  =>  水果地址
專案價  =>  專案價
水果產地  =>  水果產地
水果產量  =>  水果產量
專案問題  =>  專案問題
大量貨品  =>  大量貨品
葡萄專案  =>  葡萄專案
葡萄專線  =>  葡萄專線
專線號碼  =>  專線號碼
葡萄果農  =>  葡萄果農
規定葡萄  =>  規定葡萄
花店收件  =>  花店收件
粽子建議  =>  粽子建議
冰冰箱  =>  冰冰箱
包裹建議  =>  包裹建議
建議粽子  =>  建議粽子
粽子回家  =>  粽子回家
單軟體  =>  單軟體
軟體系統  =>  軟體系統
軟體系統分類  =>  軟體系統分類
展覽館收貨  =>  展覽館收貨
黑貓駐點  =>  黑貓駐點
駐點人員  =>  駐點人員
展場駐點  =>  展場駐點
展場黑貓  =>  展場黑貓
規定國際  =>  規定國際
國際包裹  =>  國際包裹
國際宅  =>  國際宅
國際郵件  =>  國際郵件
藥品類  =>  藥品類
包裹違禁品  =>  包裹違禁品
大陸內地  =>  大陸內地
國際線  =>  國際線
報值宅  =>  報值宅
包裹報值  =>  包裹報值
學校駐點  =>  學校駐點
時候學生  =>  時候學生
學生專案  =>  學生專案
駐點學校  =>  駐點學校
學生行李  =>  學生行李
學生方案  =>  學生方案
方案包裹  =>  方案包裹
專案駐點  =>  專案駐點
紙箱尺寸  =>  紙箱尺寸
地區學生  =>  地區學生
規定學生  =>  規定學生
行李尺寸  =>  行李尺寸
駐點學生  =>  駐點學生
方案駐點  =>  方案駐點
黑貓學生  =>  黑貓學生
學生包裹  =>  學生包裹
行李方案  =>  行李方案
行李專案  =>  行李專案
駐點攤位  =>  駐點攤位
方案行李  =>  方案行李
學生身分  =>  學生身分
專案老師  =>  專案老師
研究所學生  =>  研究所學生
機場櫃檯  =>  機場櫃檯
行李包膜  =>  行李包膜
包膜機  =>  包膜機
機場行李  =>  機場行李
行李宅  =>  行李宅
行李箱包膜  =>  行李箱包膜
尺寸規範  =>  尺寸規範
國行李  =>  國行李
門市店員  =>  門市店員
行李太重  =>  行李太重
機場包裹  =>  機場包裹
行李原因  =>  行李原因
機場內  =>  機場內
黑貓櫃檯  =>  黑貓櫃檯
行李重量  =>  行李重量
規定行李  =>  規定行李
行李體積  =>  行李體積
公分機場  =>  公分機場
行李回家  =>  行李回家
重量規定  =>  重量規定
航空公司櫃  =>  航空公司櫃
低溫機場  =>  低溫機場
班機名稱  =>  班機名稱
單子長  =>  單子長
航班資訊  =>  航班資訊
飛機時間  =>  飛機時間
機場櫃  =>  機場櫃
機場行李箱  =>  機場行李箱
國際機場  =>  國際機場
機場搭機  =>  機場搭機
搭機行李  =>  搭機行李
機場黑貓  =>  機場黑貓
機場結果  =>  機場結果
飛機出境  =>  飛機出境
出境黑貓  =>  出境黑貓
機宅  =>  機宅
雄機場  =>  雄機場
飛機行李  =>  飛機行李
原地址  =>  原地址
寄放在機場  =>  寄放在機場
櫃收費  =>  櫃收費
包裹收費  =>  包裹收費
外縣市宅  =>  外縣市宅
地區無法  =>  地區無法
低溫貨物  =>  低溫貨物
規定材積  =>  規定材積
規定宅  =>  規定宅
收件作業  =>  收件作業
原門市  =>  原門市
經濟宅  =>  經濟宅
盒子有點  =>  盒子有點
利用經濟  =>  利用經濟
電視版  =>  電視版
球版  =>  球版
紙盒虛線  =>  紙盒虛線
紙盒款式  =>  紙盒款式
紙盒趣味  =>  紙盒趣味
貓咪玩具  =>  貓咪玩具
黑貓電視機  =>  黑貓電視機
黑貓戳戳  =>  黑貓戳戳
貓玩具  =>  貓玩具
版貓咪  =>  版貓咪
成玩具  =>  成玩具
經濟文件  =>  經濟文件
業務集貨  =>  業務集貨
收貨店家  =>  收貨店家
低溫貨品  =>  低溫貨品
商經濟  =>  商經濟
門市經濟  =>  門市經濟
規定經濟  =>  規定經濟
翡翠玉鐲  =>  翡翠玉鐲
補差價  =>  補差價
補差額  =>  補差額
時候漲價  =>  時候漲價
手機專用  =>  手機專用
手機盒子  =>  手機盒子
全省便利商店  =>  全省便利商店
蝦皮收件人  =>  蝦皮收件人
包裹聯絡  =>  包裹聯絡
蝦皮資料  =>  蝦皮資料
聯絡蝦皮  =>  聯絡蝦皮
蝦皮客服  =>  蝦皮客服
蝦皮商品  =>  蝦皮商品
蝦皮賣家  =>  蝦皮賣家
客服電話號碼  =>  客服電話號碼
客服真人  =>  客服真人
真人電話  =>  真人電話
蝦皮專線  =>  蝦皮專線
蝦皮收貨  =>  蝦皮收貨
天才收件  =>  天才收件
手寫單  =>  手寫單
蝦皮客  =>  蝦皮客
蝦皮出貨單  =>  蝦皮出貨單
手寫宅  =>  手寫宅
低溫藍色  =>  低溫藍色
藍色單  =>  藍色單
常溫粉紅色  =>  常溫粉紅色
粉紅色單  =>  粉紅色單
出貨單種類  =>  出貨單種類
蝦皮包  =>  蝦皮包
單種類  =>  單種類
賣家出貨單  =>  賣家出貨單
蝦皮專用  =>  蝦皮專用
專用單  =>  專用單
單注意事項  =>  單注意事項
單通報  =>  單通報
通報流程  =>  通報流程
通報程序  =>  通報程序
物品內容  =>  物品內容
客人資料  =>  客人資料
標準格式  =>  標準格式
包裹回家  =>  包裹回家
電腦套印  =>  電腦套印
套印格式  =>  套印格式
專屬單子  =>  專屬單子
模低溫  =>  模低溫
低溫單  =>  低溫單
模常溫  =>  模常溫
常溫單  =>  常溫單
模單  =>  模單
套印資料  =>  套印資料
套印電子  =>  套印電子
語音電話  =>  語音電話
電話語音  =>  電話語音
語音專線  =>  語音專線
語音集貨  =>  語音集貨
分機語音  =>  分機語音
語音系統  =>  語音系統
語音收件  =>  語音收件
黑貓語音  =>  黑貓語音
語音無法  =>  語音無法
飯店宅  =>  飯店宅
指飯店  =>  指飯店
飯店櫃檯  =>  飯店櫃檯
業務性質  =>  業務性質
司機人  =>  司機人
客戶講話  =>  客戶講話
司機服務態度  =>  司機服務態度
司機素質  =>  司機素質
員工印象  =>  員工印象
影音宅  =>  影音宅
錄音檔案  =>  錄音檔案
個人影音  =>  個人影音
影音訊息  =>  影音訊息
影音檔  =>  影音檔
下單衛生紙  =>  下單衛生紙
網站商品  =>  網站商品
鹼性離子水  =>  鹼性離子水
生活用品網站  =>  生活用品網站
生活用品發票  =>  生活用品發票
網站下單  =>  網站下單
礦泉水發票  =>  礦泉水發票
洗衣精  =>  洗衣精
洗碗精  =>  洗碗精
報公帳  =>  報公帳
生活館商品  =>  生活館商品
商品發票  =>  商品發票
衛生紙價格  =>  衛生紙價格
礦泉水價格  =>  礦泉水價格
商品售價  =>  商品售價
礦泉水售價  =>  礦泉水售價
速達礦泉水  =>  速達礦泉水
黑貓礦泉水  =>  黑貓礦泉水
廚房紙巾  =>  廚房紙巾
實際價格  =>  實際價格
商品價錢  =>  商品價錢
衛生紙司機  =>  衛生紙司機
衛生紙宅  =>  衛生紙宅
衛生紙下單  =>  衛生紙下單
能量飲料  =>  能量飲料
運門檻  =>  運門檻
網礦泉水  =>  網礦泉水
礦泉水運送費  =>  礦泉水運送費
運送費要花費  =>  運送費要花費
衛生紙運送費  =>  衛生紙運送費
網衛生紙  =>  網衛生紙
飲料運送費  =>  飲料運送費
生活用品宅  =>  生活用品宅
網飲料  =>  網飲料
黑貓衛生紙  =>  黑貓衛生紙
生活用品種類  =>  生活用品種類
網生活用品  =>  網生活用品
包裝材料商品  =>  包裝材料商品
商聯絡  =>  商聯絡
聯絡門市  =>  聯絡門市
商客服  =>  商客服
商電話  =>  商電話
聯絡方法  =>  聯絡方法
便利商店店  =>  便利商店店
客戶專屬  =>  客戶專屬
指主管  =>  指主管
宗旨信念  =>  宗旨信念
世紀風味  =>  世紀風味
企業種類  =>  企業種類
夢時代  =>  夢時代
區郵遞區號  =>  區郵遞區號
郵局區碼  =>  郵局區碼
小朋友體驗  =>  小朋友體驗
體驗業務員  =>  體驗業務員
電子檔  =>  電子檔
黑貓桌  =>  黑貓桌
電腦桌布  =>  電腦桌布
黑貓桌布  =>  黑貓桌布
黑貓電子  =>  黑貓電子
電子桌布  =>  電子桌布
黑貓物品  =>  黑貓物品
廠商名單  =>  廠商名單
員工名冊  =>  員工名冊
營運報表  =>  營運報表
營運資料  =>  營運資料
營運數字  =>  營運數字
規定男生  =>  規定男生
黑貓代言人  =>  黑貓代言人
黑貓先生  =>  黑貓先生
學校報告  =>  學校報告
中心現場  =>  中心現場
作業流程  =>  作業流程
參觀黑貓  =>  參觀黑貓
黑貓轉運站  =>  黑貓轉運站
學生參觀  =>  學生參觀
參觀轉運站  =>  參觀轉運站
黑貓營業  =>  黑貓營業
學校學生  =>  學校學生
地點參觀  =>  地點參觀
快遞業者  =>  快遞業者
建議消費者  =>  建議消費者
蜂蜜蛋糕  =>  蜂蜜蛋糕
烤肉用具  =>  烤肉用具
嬰兒床  =>  嬰兒床
物流運輸業  =>  物流運輸業
故事投稿  =>  故事投稿
貨頻率  =>  貨頻率
網路會員  =>  網路會員
黑貓網路  =>  黑貓網路
會員方式  =>  會員方式
網會員  =>  網會員
申請加入黑貓  =>  申請加入黑貓
網辦理  =>  網辦理
網路會員資料  =>  網路會員資料
網路會員帳號  =>  網路會員帳號
會員帳號名稱  =>  會員帳號名稱
聯絡信箱  =>  聯絡信箱
會員密碼  =>  會員密碼
會員無法  =>  會員無法
會員專區  =>  會員專區
專區訂單  =>  專區訂單
著黑貓  =>  著黑貓
學校建教合作  =>  學校建教合作
員工工作服  =>  員工工作服
貓雪  =>  貓雪
黑貓貨運車  =>  黑貓貨運車
拍片作業  =>  拍片作業
營業所拍片  =>  營業所拍片
微電影  =>  微電影
黑貓道具  =>  黑貓道具
專線報案  =>  專線報案
遺失宅  =>  遺失宅
聯絡司機  =>  聯絡司機
聯絡車主  =>  聯絡車主
黑貓貨物  =>  黑貓貨物
公關部門  =>  公關部門
公關代表  =>  公關代表
代表聯繫  =>  代表聯繫
黑貓公關  =>  黑貓公關
公關人員  =>  公關人員
人員聯繫  =>  人員聯繫
公關部聯絡  =>  公關部聯絡
客服對話  =>  客服對話
專人電話  =>  專人電話
專人客服  =>  專人客服
聯絡黑貓  =>  聯絡黑貓
中心電話  =>  中心電話
中心聯絡  =>  中心聯絡
聯絡專人  =>  聯絡專人
黑貓聯絡  =>  黑貓聯絡
客服信箱  =>  客服信箱
拍賣會公告  =>  拍賣會公告
物流公司  =>  物流公司
物流聯絡  =>  物流聯絡
連絡方式  =>  連絡方式
包裹費用  =>  包裹費用
結帳單  =>  結帳單
結款項  =>  結款項
客戶帳單  =>  客戶帳單
客戶帳目  =>  客戶帳目
客戶無法  =>  客戶無法
地點分店  =>  地點分店
地點地址  =>  地點地址
帳號地址  =>  帳號地址
客戶帳號  =>  客戶帳號
會派快遞  =>  會派快遞
會派業務  =>  會派業務
帳務內容  =>  帳務內容
客戶帳務  =>  客戶帳務
客代入  =>  客代入
問帳單  =>  問帳單
合約書寫  =>  合約書寫
合約書吧  =>  合約書吧
人員姓名  =>  人員姓名
法務單位  =>  法務單位
單位聯絡  =>  單位聯絡
法務部門  =>  法務部門
員工聯絡  =>  員工聯絡
核實  =>  核實
聯絡速達  =>  聯絡速達
速達員工  =>  速達員工
員工方式  =>  員工方式
理貨人員  =>  理貨人員
黑貓員工  =>  黑貓員工
機車宅  =>  機車宅
晨間理貨  =>  晨間理貨
貨物遺失  =>  貨物遺失
部落格  =>  部落格
黑貓商標  =>  黑貓商標
品牌商品  =>  品牌商品
黑貓車子  =>  黑貓車子
黑貓筆  =>  黑貓筆
季節商品  =>  季節商品
黑貓探險隊  =>  黑貓探險隊
探險隊網路  =>  探險隊網路
探險隊商品  =>  探險隊商品
黑貓探險  =>  黑貓探險
探險線  =>  探險線
黑貓商品  =>  黑貓商品
問營業所  =>  問營業所
案件名稱  =>  案件名稱
市政府收貨  =>  市政府收貨
法院收貨  =>  法院收貨
郵局收貨  =>  郵局收貨
區公所收貨  =>  區公所收貨
政府機關  =>  政府機關
電力公司收貨  =>  電力公司收貨
案件編號  =>  案件編號
電力公司集貨  =>  電力公司集貨
電力公司收件  =>  電力公司收件
百貨櫃  =>  百貨櫃
百貨公司收貨  =>  百貨公司收貨
百貨公司櫃  =>  百貨公司櫃
百貨收件  =>  百貨收件
百貨公司集貨  =>  百貨公司集貨
百貨公司地址  =>  百貨公司地址
公司收貨  =>  公司收貨
百貨公司收件  =>  百貨公司收件
公司集貨  =>  公司集貨
水公司  =>  水公司
公司收件  =>  公司收件
水集貨  =>  水集貨
水收貨  =>  水收貨
時代包裹  =>  時代包裹
時代收貨  =>  時代收貨
攤位號碼  =>  攤位號碼
物流拿貨  =>  物流拿貨
貨運物流  =>  貨運物流
物流倉庫  =>  物流倉庫
倉庫集貨  =>  倉庫集貨
倉庫收件  =>  倉庫收件
社辦收件  =>  社辦收件
學校收件  =>  學校收件
學校辦公室  =>  學校辦公室
學生宿舍收件  =>  學生宿舍收件
學校地點  =>  學校地點
學校內  =>  學校內
醫院包裹  =>  醫院包裹
醫院收件  =>  醫院收件
醫院住院  =>  醫院住院
醫藥學院  =>  醫藥學院
總醫院收件  =>  總醫院收件
醫院收貨  =>  醫院收貨
物流收貨  =>  物流收貨
著手  =>  著手
紙本發票  =>  紙本發票
室兒童  =>  室兒童
包裹發票  =>  包裹發票
發票消失  =>  發票消失
發票事宜  =>  發票事宜
包裹手續費  =>  包裹手續費
問手續費  =>  問手續費
包裹快遞費  =>  包裹快遞費
包裹運送費  =>  包裹運送費
門市帳務  =>  門市帳務
商帳務  =>  商帳務
帳務問題  =>  帳務問題
帳目有點  =>  帳目有點
發票金額  =>  發票金額
標的數字  =>  標的數字
尺寸量  =>  尺寸量
森包裹  =>  森包裹
森下單  =>  森下單
森網  =>  森網
森購物  =>  森購物
森訂單  =>  森訂單
森購物網  =>  森購物網
森商品  =>  森商品
黑貓個人資料  =>  黑貓個人資料
個人資料保戶  =>  個人資料保戶
官網網  =>  官網網
網網資料  =>  網網資料
連絡客服  =>  連絡客服
方式電話  =>  方式電話
聯繫客服  =>  聯繫客服
客服方式  =>  客服方式
液體包裹  =>  液體包裹
包裹儲物櫃  =>  包裹儲物櫃
語音功能  =>  語音功能
營業時段  =>  營業時段
假營  =>  假營
黑貓營業時間  =>  黑貓營業時間
膽島  =>  膽島
大膽島  =>  大膽島
區域範圍  =>  區域範圍
雄夢  =>  雄夢
時代櫃  =>  時代櫃
時代百貨  =>  時代百貨
智能宅  =>  智能宅
發票號碼  =>  發票號碼
發票紀錄  =>  發票紀錄
紀錄發票  =>  紀錄發票
網紀錄  =>  網紀錄
電子發票  =>  電子發票
發票專區  =>  發票專區
文字客服  =>  文字客服
文字對話  =>  文字對話
對話系統  =>  對話系統
智能客服  =>  智能客服
客服機器人  =>  客服機器人
真人時間  =>  真人時間
方式貨  =>  方式貨
客戶電子  =>  客戶電子
紙本合約  =>  紙本合約
匯款時間  =>  匯款時間
時間算法  =>  時間算法
